XXXXXXXXXXXXXXXXXXXXXXXXX
X_______________________X
X_______________________X
X_______________XXXX____X
X________________XX_____X
X__X____________________X
X__XX___________________X
X__X____________________X
X________XXXXXXX________X
X_________XXX___________X
X___________X___________X
X__________________XXXXXX
X_______________________X
X_______________________X
XXXXX___________________X
XXXX___________XXXX_____X
X________XXXXXXXXXXX____X
X__________XXXX_________X
X_______________________X
X_______________________X
X_______________________X
X________________XXX____X
X_______________________X
X_____XX________________X
X___XXXXX_______________X
XXXXXXXXXXXXXXXXXXXXXXXXX
